NO textures/mossy.xpm
SO textures/greystone.xpm
WE textures/eagle1701187887.xpm
EA textures/colorstone.xpm

F 165,82,45
C 135,206,235

1111111111111111111111111
1000000000110000000000001
1011000001110000000000001
1001000000000000000000001
100000000011000001110111111111111
111101111N11111011100000010001
11110111111111011101010010001
11000000110101011100000010001
10000000000000001100000010001
10000000000000001101010010001
110000011101010111110111100111
11110111111101011101111010001
11111111111111111111111111111